+----------+
|   *    S |
|  ****  * |
|***  **** |
|*     *   |
|********* |
|   *    * |
|  **  *** |
|  F  **   |
+----------+